########
#      #
# P  X #
#   OX #
#   O  #
########