    ################
####                ####
#          X           #
#          O           #
#   X  P    X      #####
#        X             #
#      O      X        #
#                      #
############           #
  # OOO         X      #
  #           O        #
  #                    #
  ######################