#####################
#                   #
#                   #
#                   #
#       X           #
#           #########
#              P    #
#                   #
############        #
############  O     #
#                   #
#                   #
#      X       O    #
##        ###########
#     X            ##
#                 O## 
#####################